MMMMMMMMMMMMMNDIIIIII8NMMMMMMMMMNMMMMMMM
MMMMMMMNDIIIIIIIIIIIIIIIIMMMMMD+DMMMMMMM
MMMMM?IIIIIIIIIIIIIIIIIIIIIMMD??+??NMMMM
MMMNIIIIIIIIIIIIIIIIIIIIIIIIDMM???8D7MMM
MMIIIIIIDDDDDDDNIDDDDIIIIIIIIIMMD??NMMMM
MIIIIIIN+D::::::::NNDDDDDIIIIIIMMMMMMMMM
DIII+MM?:.    D::D . D::N:8IIIINMMMMMMMM
I$MMMMM:.  7II+M      .:,:III8MMN+?NMMMM
NMMMMMN:   ININ   ?INI=:.,IIDMNN8+?+NMMM
MMMMMM::+  N.:N   II8I: ,I7MMMMMDNMMMMMM
MMMMMM,::D,=:::~.  .8D. $D..,D:DMMMMMMMM
MMMMMMD::::$:::::::Z.. :::8Z::,NMMMMMMMM
MMMMMMMN::::...$NDIIII,:=:=MD:.MMMMMMMMM
MMMMMMMMN,::::::IIZ=D:7NNMM7MMMMMMMMMMMM
MMMMMMMMMMD::D,ION:::DD,:MMMMMMMMMMMMMMM
MMMMMMMMMMMMMMNN:::D8..?,NMMMMMMMMMMMMMM
MMMMMMMMMMMMM+.....N..DMMMMMMMMMMMMMMMMM
MMMMMMMMMMMMM....+.N++MMMMMMMMMMMMMMMMMM
MMMMMMMMMMMM$DDD.D.MMMMMMMMMMMMMMMMMMMMM
MMMMMMMMMMMMDMMDD.MMMMMMMMMMMMMMMMMMMMMM
MMMMMMMMMMMMMMMMD?MMMMMMMMMMMMMMMMMMMMMM
MMMMMMMMMMMMMMMMD8DMMMMMMMMMMMMMMMMMMMMM
MMMMMMMMMMMMMMMMMMMMMMMMMMMMMMMMMMMMMMMM
MMMMMMMMMMMMMMMMMMMMMMMMMMMMMMMMMMMMMMMM
